Form: Package_Management
------------------------------------
Name: txtPackageAdd_Name	Typ: TextBox
Name: Bezeichnungsfeld1	Typ: Label
Name: cmdPackage_Add	Typ: CommandButton
Name: Bezeichnungsfeld3	Typ: Label
Name: cmbPackageManage_Name	Typ: ComboBox
Name: Bezeichnungsfeld6	Typ: Label
Name: lstConnectedClasses	Typ: ListBox
Name: Bezeichnungsfeld11	Typ: Label
Name: txtClass_Create_Name	Typ: TextBox
Name: Label14	Typ: Label
Name: Label15	Typ: Label
Name: cmbClass_AddExisting	Typ: ComboBox
Name: cmdClass_Create	Typ: CommandButton
Name: cmdClass_AddExisting	Typ: CommandButton
Name: lstConnectedProperties	Typ: ListBox
Name: Label22	Typ: Label
Name: lstConnectedMethods	Typ: ListBox
Name: Label25	Typ: Label
Name: Line26	Typ: Line
Name: txtProperty_Draft_Name_Create	Typ: TextBox
Name: Label28	Typ: Label
Name: Label29	Typ: Label
Name: cmbProperty_Existing	Typ: ComboBox
Name: Command31	Typ: CommandButton
Name: cmdProperty_Add_Existing	Typ: CommandButton
Name: Line33	Typ: Line
Name: Line34	Typ: Line
Name: List35	Typ: ListBox
Name: Label36	Typ: Label
Name: Label39	Typ: Label
Name: Combo40	Typ: ComboBox
Name: Command42	Typ: CommandButton
Name: EmptyCell53	Typ: EmptyCell
Name: EmptyCell55	Typ: EmptyCell
Name: EmptyCell61	Typ: EmptyCell
Name: EmptyCell63	Typ: EmptyCell
Name: EmptyCell64	Typ: EmptyCell
Name: EmptyCell66	Typ: EmptyCell
Name: EmptyCell73	Typ: EmptyCell
Name: EmptyCell74	Typ: EmptyCell
Name: EmptyCell75	Typ: EmptyCell
Name: EmptyCell76	Typ: EmptyCell
Name: EmptyCell77	Typ: EmptyCell
Name: EmptyCell78	Typ: EmptyCell
Name: EmptyCell85	Typ: EmptyCell
Name: EmptyCell86	Typ: EmptyCell
Name: EmptyCell87	Typ: EmptyCell
Name: EmptyCell92	Typ: EmptyCell
Name: EmptyCell94	Typ: EmptyCell
Name: EmptyCell95	Typ: EmptyCell
Name: EmptyCell96	Typ: EmptyCell
Name: EmptyCell97	Typ: EmptyCell
Name: EmptyCell98	Typ: EmptyCell
Name: EmptyCell99	Typ: EmptyCell
Name: EmptyCell100	Typ: EmptyCell
Name: EmptyCell101	Typ: EmptyCell
